make a decision=做决定
take a break=休息一下
pay attention=注意
make progress=取得进步
have a look=看一看
give up=放弃
carry out=执行
deal with=处理
depend on=依靠
belong to=属于
look forward to=期待
be proud of=为……感到骄傲
be interested in=对……感兴趣
be good at=擅长
be famous for=因……而出名
be afraid of=害怕
be full of=充满
be responsible for=对……负责
be satisfied with=对……满意
be strict with=对……严格
get ready=准备好
get up=起床
get along with=与……相处
get rid of=摆脱
get used to=习惯于
come from=来自
come true=实现
come back=回来
come up with=想出
go ahead=继续
go on=继续
go out=出去
go over=复习
go through=经历
look after=照顾
look for=寻找
look up=查阅
look into=调查
look like=看起来像
put on=穿上
put off=推迟
put away=收拾
put up=张贴
turn on=打开
turn off=关闭
turn up=调大/出现
turn down=调小/拒绝
try out=尝试
try on=试穿
take off=起飞/脱下
take care of=照顾
take part in=参加
take place=发生
take turns=轮流
give back=归还
give in=屈服
give out=分发/耗尽
help with=帮助……
help oneself to=随便吃
have fun=玩得开心
have trouble=有困难
have in mind=心中想到
in fact=事实上
in time=及时
in danger=处于危险中
in need=需要
in public=当众
at first=起初
at last=最后
at once=立刻
at least=至少
at present=目前
on time=准时
on foot=步行
on purpose=故意
on sale=打折
by hand=用手
by accident=偶然
by mistake=错误地
by the way=顺便说一下
as soon as=一……就……
as usual=像往常一样
as well as=也，还
so far=到目前为止
such as=例如
instead of=代替
because of=由于
thanks to=多亏了
according to=根据